Andee	KEYWORD1
AndeeHelper	KEYWORD1
bool	KEYWORD1

UNKNOWN	LITERAL1
BUTTON_IN	LITERAL1
CIRCLE_BUTTON	LITERAL1
DATA_OUT	LITERAL1
KEYBOARD_IN	LITERAL1
SD_WRITE	LITERAL1
SD_READ	LITERAL1
SMS_SENDER	LITERAL1
NOTIFICATION	LITERAL1
DATE_IN	LITERAL1
TIME_IN	LITERAL1
CAMERA	LITERAL1
SLIDER_IN	LITERAL1
TTS	LITERAL1
ANALOG_DIAL_OUT	LITERAL1

//For iOS
DATA_OUT_TEXT	LITERAL1
DATA_OUT_CIRCLE	LITERAL1


JAN	LITERAL1
FEB	LITERAL1
MAR	LITERAL1
APR	LITERAL1
MAY	LITERAL1
JUN	LITERAL1
JUL	LITERAL1
AUG	LITERAL1
SEP	LITERAL1
OCT	LITERAL1
NOV	LITERAL1
DEC	LITERAL1

PINK	LITERAL1
LIGHT_PINK	LITERAL1
HOT_PINK	LITERAL1
DEEP_PINK	LITERAL1
PALE_VIOLET_RED	LITERAL1
MEDIUM_VIOLET_RED	LITERAL1
LIGHT_SALMON	LITERAL1
SALMON	LITERAL1
DARK_SALMON	LITERAL1
LIGHT_CORAL	LITERAL1
INDIAN_RED	LITERAL1
CRIMSON	LITERAL1
FIRE_BRICK	LITERAL1
DARK_RED	LITERAL1
RED	LITERAL1
ORANGE_RED	LITERAL1
TOMATO	LITERAL1
CORAL	LITERAL1
DARK_ORANGE	LITERAL1
ORANGE	LITERAL1
GOLD	LITERAL1
YELLOW	LITERAL1
LIGHT_YELLOW	LITERAL1
LEMON_CHIFFON	LITERAL1
LIGHT_GOLDENROD_YELLOW	LITERAL1
PAPAYA_WHIP	LITERAL1
MOCCASIN	LITERAL1
PEACH_PUFF	LITERAL1
PALE_GOLDENROD	LITERAL1
KHAKI	LITERAL1
DARK_KHAKI	LITERAL1
CORNSILK	LITERAL1
BLANCHED_ALMOND	LITERAL1
BISQUE	LITERAL1
NAVAJO_WHITE	LITERAL1
WHEAT	LITERAL1
BURLYWOOD	LITERAL1
TAN	LITERAL1
ROSY_BROWN	LITERAL1
SANDY_BROWN	LITERAL1
GOLDENROD	LITERAL1
DARK_GOLDENROD	LITERAL1
PERU	LITERAL1
CHOCOLATE	LITERAL1
SADDLE_BROWN	LITERAL1
SIENNA	LITERAL1
BROWN	LITERAL1
MAROON	LITERAL1
DARK_OLIVE_GREEN	LITERAL1
OLIVE	LITERAL1
OLIVE_DRAB	LITERAL1
YELLOW_GREEN	LITERAL1
LIME_GREEN	LITERAL1
LIME	LITERAL1
LAWN_GREEN	LITERAL1
CHARTREUSE	LITERAL1
GREEN_YELLOW	LITERAL1
SPRING_GREEN	LITERAL1
MEDIUM_SPRING_GREEN	LITERAL1
LIGHT_GREEN	LITERAL1
PALE_GREEN	LITERAL1
DARK_SEA_GREEN	LITERAL1
MEDIUM_SEA_GREEN	LITERAL1
SEA_GREEN	LITERAL1
FORREST_GREEN	LITERAL1
GREEN	LITERAL1
DARK_GREEN	LITERAL1
MEDIUM_AQUAMARINE	LITERAL1
AQUA	LITERAL1
CYAN	LITERAL1
LIGHT_CYAN	LITERAL1
PALE_TURQUOISE	LITERAL1
AQUAMARINE	LITERAL1
TURQUOISE	LITERAL1
MEDIUM_TURQUOISE	LITERAL1
DARK_TURQUOISE	LITERAL1
LIGHT_SEA_GREEN	LITERAL1
CADET_BLUE	LITERAL1
DARK_CYAN	LITERAL1
TEAL	LITERAL1
LIGHT_STEEL_BLUE	LITERAL1
POWDER_BLUE	LITERAL1
LIGHT_BLUE	LITERAL1
SKY_BLUE	LITERAL1
LIGHT_SKY_BLUE	LITERAL1
DEEP_SKY_BLUE	LITERAL1
DODGER_BLUE	LITERAL1
CORNFLOWER_BLUE	LITERAL1
STEEL_BLUE	LITERAL1
ROYAL_BLUE	LITERAL1
BLUE	LITERAL1
MEDIUM_BLUE	LITERAL1
DARK_BLUE	LITERAL1
NAVY	LITERAL1
MIDNIGHT_BLUE	LITERAL1
LAVENDER	LITERAL1
THISTLE	LITERAL1
PLUM	LITERAL1
VIOLET	LITERAL1
ORCHID	LITERAL1
FUCHSIA	LITERAL1
MAGENTA	LITERAL1
MEDIUM_ORCHID	LITERAL1
MEDIUM_PURPLE	LITERAL1
BLUE_VIOLET	LITERAL1
DARK_VIOLET	LITERAL1
DARK_ORCHID	LITERAL1
DARK_MAGENTA	LITERAL1
PURPLE	LITERAL1
INDIGO	LITERAL1
DARK_SLATE_BLUE	LITERAL1
SLATE_BLUE	LITERAL1
MEDIUM_SLATE_BLUE	LITERAL1
WHITE	LITERAL1
SNOW	LITERAL1
HONEYDEW	LITERAL1
MINT_CREAM	LITERAL1
AZURE	LITERAL1
ALICE_BLUE	LITERAL1
GHOST_WHITE	LITERAL1
WHITE_SMOKE	LITERAL1
SEASHELL	LITERAL1
BEIGE	LITERAL1
OLD_LACE	LITERAL1
FLORAL_WHITE	LITERAL1
IVORY	LITERAL1
ANTIQUE_WHITE	LITERAL1
LINEN	LITERAL1
LAVENDER_BLUSH	LITERAL1
MISTY_ROSE	LITERAL1
GAINSBORO	LITERAL1
LIGHTGRAY	LITERAL1
SILVER	LITERAL1
DARK_GRAY	LITERAL1
GRAY	LITERAL1
DIM_GRAY	LITERAL1
LIGHT_SLATE_GRAY	LITERAL1
SLATE_GRAY	LITERAL1
DARK_SLATE_GRAY	LITERAL1
BLACK	LITERAL1
TRANSPARENT	LITERAL1
DKGRAY 	LITERAL1
LTGRAY	LITERAL1
LIGHT_BLUE	LITERAL1
TEXT_LIGHT	LITERAL1
TEXT_DARK	LITERAL1
DEFAULT_COLOR	LITERAL1
DEFAULT_TITLE_COLOR	LITERAL1
THEME_TURQUOISE	LITERAL1
THEME_TURQUOISE_DARK	LITERAL1
THEME_GREEN	LITERAL1
THEME_GREEN_DARK	LITERAL1
THEME_BLUE	LITERAL1
THEME_BLUE_DARK	LITERAL1
THEME_PURPLE	LITERAL1
THEME_PURPLE_DARK	LITERAL1
THEME_MIDNIGHT	LITERAL1
THEME_MIDNIGHT_DARK	LITERAL1
THEME_YELLOW	LITERAL1
THEME_YELLOW_DARK	LITERAL1
THEME_ORANGE	LITERAL1
THEME_ORANGE_DARK	LITERAL1
THEME_RED	LITERAL1
THEME_RED_DARK	LITERAL1
THEME_GREY	LITERAL1
THEME_GREY_DARK	LITERAL1
THEME_DEFAULT	LITERAL1
THEME_DEFAULT_DARK	LITERAL1


ONE_QUART	LITERAL1
HALF	LITERAL1
THREE_QUART	LITERAL1
FULL	LITERAL1
ONE_THIRD	LITERAL1
TWO_THIRD	LITERAL1

ANDEE_NUMERIC_B_PW	LITERAL1
ANDEE_NUMERIC_A_PW	LITERAL1
ANDEE_NUMERIC_B	LITERAL1
ANDEE_NUMERIC_A	LITERAL1
ALPHA_NUMERIC	LITERAL1
ALPHA_NUMERIC_PW	LITERAL1
ANDROID_NUMERIC	LITERAL1
ANDROID_NUMERIC_PW	LITERAL1

DEFAULT	LITERAL1
FRONT	LITERAL1
REAR	LITERAL1
ON	LITERAL1
OFF	LITERAL1
AUTO	LITERAL1
SDCARD	LITERAL1

AUTO	LITERAL1
AUTO_PORTRAIT	LITERAL1
AUTO_LANDSCAPE	LITERAL1
PORTRAIT	LITERAL1
PORTRAIT_REVERSE	LITERAL1
LANDSCAPE	LITERAL1
LANDSCAPE_REVERSE	LITERAL1

ON_VALUE_CHANGE	LITERAL1
ON_FINGER_UP	LITERAL1
INT	LITERAL1
FLOAT	LITERAL1

NOT_CONNECTED	LITERAL1
CONNECTED	LITERAL1
TIMEOUT	LITERAL1

US	LITERAL1
GREAT_BRITON	LITERAL1
AUTRALIA	LITERAL1
IRELAND	LITERAL1
SOUTH_AFRICA	LITERAL1


begin	KEYWORD2
sendCommand	KEYWORD2
readLineFromSD	KEYWORD2
readBytesFromSD	KEYWORD2
appendSD	KEYWORD2
writeSD	KEYWORD2
hasReset	KEYWORD2
isConnected	KEYWORD2
clear	KEYWORD2
disconnect	KEYWORD2

setOrder	KEYWORD2
setRow	KEYWORD2
setSpan	KEYWORD2
setType	KEYWORD2
setLocation	KEYWORD2
setTitle	KEYWORD2
setUnit	KEYWORD2
setData	KEYWORD2
setId	KEYWORD2
update	KEYWORD2
updateData	KEYWORD2
remove	KEYWORD2
isPressed	KEYWORD2
ack	KEYWORD2
getKeyboardMessage	KEYWORD2
sendNotification	KEYWORD2
sendSMS	KEYWORD2
setColor	KEYWORD2
setTitleColor	KEYWORD2
setTextColor	KEYWORD2
setTitleTextColor	KEYWORD2
setKeyboardType	KEYWORD2
setHintText	KEYWORD2
setRecipient	KEYWORD2
setMessage	KEYWORD2
send	KEYWORD2
setTicker	KEYWORD2
notify	KEYWORD2
getDateInput	KEYWORD2
getTimeInput	KEYWORD2
setDefaultDate	KEYWORD2
setDefaultTime	KEYWORD2
setDefaultTime	KEYWORD2
getDeviceTimeStamp	KEYWORD2
getDeviceDate	KEYWORD2
getDeviceTime	KEYWORD2
printDeviceTime	KEYWORD2
setCamera	KEYWORD2
setAutoFocus	KEYWORD2
setFlash	KEYWORD2
takePhoto	KEYWORD2
setPhotoFilename	KEYWORD2
setFileOverwrite	KEYWORD2
setSaveLocation	KEYWORD2
getLastTakePhotoResult	KEYWORD2
takePhotoResultReady	KEYWORD2
requireAck	KEYWORD2
getButtonPressCount	KEYWORD2
setSliderMinMax	KEYWORD2
setSliderInitialValue	KEYWORD2
setSliderNumIntervals	KEYWORD2
setSliderReportMode	KEYWORD2
moveSliderToValue	KEYWORD2
newSliderValueAvailable	KEYWORD2
getSliderValue	KEYWORD2
setScreenOrientation	KEYWORD2
screenAlwaysOn	KEYWORD2
setSliderColor	KEYWORD2
moveSliderToValue	KEYWORD2
setUtteranceSpeed	KEYWORD2
setPitchModifier	KEYWORD2
setAccent	KEYWORD2
setMinMax	KEYWORD2
setSubColor	KEYWORD2
setMainColor	KEYWORD2
setDataUnitTextColor	KEYWORD2
setPitch	KEYWORD2
